******************
*                *
* ************** *
* *            * *
* * ********** * *
* * *        * * *
* * * ****** * * *
* * *    Bo* * * *
* * * * **** * * *
* * * *      * * *
* * * * ****** * *
* * *          * *
* * ************ *
*G*              *
******************